######################################################################
#                                            ##                      #
#########                          ##########                        #
#                                                                    #
#.....                               ..........                      #
#                                                                    #
#                                                    ...........     #
#                                                                    #
#                                  ##                                #
###########                        ############                      #
###########                        ############                      #
#........                          ##........                        #
#                                  ##                                #
#                                  ##                                #
#                                                                    #
#..........                          ..........                      #
#                                                                    #
#  ############                        ############                  #
#  ############                                                      #
#                                                                    #
#...........                         ...........                     #
#                                  ##                  ###########   #
#                                  ##                                #
#                                  ##                                #
#  ........                        ##  .......                       #
#                                  ##                                #
########                           ########                          #
########                                                        .....#
#                                                                    #
#                                                                    #
#                                                                    #
#                                                             ########
#                                                                    #
#                                                                    #
######################################################################